Abandon (v) : Bỏ rơi
Absolute (adj) : Tuyệt đối
Academic (n) : Giới học giả
Acceptable (adj) : Có thể chấp nhận được
Accompany (v) : Đồng hành
Account (v) : Cho là, tính là
Accurate (adj) : Chính xác
Accuse (v) : Buộc tội
Acknowledge (v) : Công nhận
Acquire (v) : Có được, thu được
Actual (adj) : Thực tế, thực sự
Adapt (v) : Thích ứng, thích nghi
Additional (adj) : Thêm, bổ sung
Address (v) : Đã cập tới, bàn tới, nhắc tới
Administration (n) : Chính quy, ban quản trị
Adopt (v) : Nhận nuôi, áp dụng
Advance (adj) : Báo trước, ứng trước
Advance (n) : Tiền ứng trước, bước tiến
Advance (v) : Tiến bộ
Affair (n) : Công chuyện, việc, vụ ngoại tình
Afterwards (adv) : Sau đó
Agency (n) : Đại lý, cơ quan
Agenda (n) : Kế hoạch, chương trình
Aggressive (adj) : Hung hang
Aid (n) : Viện trợ
Aid (v) : Hỗ trợ
Aircraft (n) : Máy bay, phi cơ
Alarm (v) : Cảnh báo
Alter (v) : Thay đổi
Amount (v) : Số lượng, số tiền
Anger (n) : Sự phẩn nộ, tức giận
Angle (n) : Góc
Anniversary (n) : Ngày kỉ niệm
Annual (adj) : Hàng năm
Anxious (adj) : Lo lắng
Apparent (adj) : Rõ rang, minh bạch
Apparently (adv) : Rõ ràng có vẻ là
Appeal (n) : Điểm thu hút, sự kháng cáo
Appeal (v) : Thu hút, kháng cáo
Approach (n) : Hướng tiếp cận
Approach (v) : Tiếp cận
Appropriate (adj) : Thích hợp
Approval (n) : Sự chấp thuận, sự phê duyệt
Approve (v) : Chấp thuận, phê duyệt
Arise (v) : Nảy sinh
Armed (adj) : Vũ trang
Arms (n) : Vũ khí, súng đạn
Artificial (adj) : Nhận tạo
Artistic (adj) : Thuộc về nghệ thuật
Ashamed (adj) : Hổ thẹn
Aspect (n) : Khía cạnh
Assess (v) : Đánh giá
Assessment (n) : Sự thẩm định, sự đánh gái, bài kiểm tra
Associate (v) : Liên kết, liên đới
Associated (adj) : Có liên quan, có quan hệ
Association (n) : Sự liên kết, hiệp hội, tổ chức
Assume (v) : Giả định, giả sử, tự cho là
Attempt (n) : Nỗ lực, sự cố gắng
Attempt (v) : Cố gắng, thử
Back (v) : Ủng hộ, hậu thuẫn
Bacteria (n) : Vi khuẩn
Bar (v) : Cấm, ngăn cản
Barrier (n) : Rào cản, trở ngại
Basically (adv) : Về cơ bản là
Battle (v) : Đấu tranh, chiến đấu
Bear (v) : Chịu đựng
Beat (n) : Nhịp điệu
Beg (v) : Ăn xin, cầu xin
Being (n) : Sinh vật
Bent (adj) : Cong, không thẳng
Bet (n) : Vụ cá cược, cá độ
Bet (v) : Cá cược, cá độ
Beyond (adv) : Hơn thế nữa
Beyond (prep) : Vượt ra ngoài cái gì
Bill (v) : Tính tiền
Bitter (adj) : Đắng
Blame (n) : Sự đổ lỗi, sự đổ thừa
Blame (v) : Đổ lỗi, đổ thừa
Blind (adj) : Mù, không thấy đường
Bond (n) : Mối liên kết, sự gắn kết
Border (v) : Ở sát, ở cạnh
Breast (n) : Ngực, bầu vú
Brief (adj) : Ngắn gọn
Broad (adj) : Rộng, đa dạng
Broadcast (n) : Chương trình phát sóng
Broadcast (v) : Phát sóng
Budget (n) : Ngân sách
Bullet (n) : Viên đạn
Bunch (n) : Một bó, một chum
Burn (n) : Vết bỏng
Bush (n) : Bụi rậm, bụi cây
But (prep) : Nhưng
Cable (n) : Cáp
Caculate (v) : Tính toán
Cancel (n) : Hủy bỏ
Cancer (n) : Bệnh ung thư
Capable (adj) : Có khả năng
Capacity (n) : Sức chứa, công suất, dung tích
Capture (v) : Sự bắt giữ
Capture (v) : Bắt giữ, chiếm được
Cast (n) : Dàn diễn viên
Cast (v) : Tuyển chọn
Catch (n) : Sự bắt lấy
Cell (n) : Ô, khung, tế bào, phòng giam
Chair (v) : Làm chủ tọa, chủ trì, giữ chức chủ tịch
Chari (v) : Xích lại, trói lại
Chaiman (n) : Chủ tịch
Challenge (v) : Thử thách
Characteristic (adj) : Thuộc về đặc tinsh, tiêu biểu
Characteristic (n) : Đặc tính, đặc điểm
Chart (v) : Lập biểu đồ, thống kê
Chief (adj) : Chính yếu, trưởng
Chief (n) : Sếp, thủ lĩnh, người lãnh đạo
Circumstance (n) : Hoàn cảnh
Cite (v) : Trích dẫn
Citizen (n) : Công dân
Civil (adj) : Dân sự, lịch sự
Classic (adj) : Cổ điển
Classic (n) : Tác phẩm kinh điển
Close (n) : Sự kết thúc, cái kết
Closely (adv) : Một cách chặt chẽ
Collapse (n) : Sự sụp đổ
Collapse (v) : Sụp đổ
combination (n) : Sự kết hợp
comfort (n) : Sự thoải mái
comfort (v) : An ủi
command (n) : Mệnh lệnh, chỉ thị
command (v) : Chỉ huy, ra lệnh
commission (n) : Hội đồng, ủy ban, hoa hồng
commission (v) : Ủy thác
commitment (n) : Nhiệm vụ, lời cam kết
committee (n) : Ủy ban
commonly (adv) : Thông thường
complex (n) : Dãy nhà, quần thể
complicated (adj) : Phức tạp
component (n) : Thành phần
Concentration (n) : Sự tập trung
Concept (n) : Khái niệm
Concern (n) : Mối lo ngại
Concern (v) : Lo ngại, e ngại, liên quan
Concerned (adj) : Lo ngại
Conduct (n) : Cách hành xử, hạnh kiểm
Conduct (v) : Cư xử, tổ chức, thực hiện
Confidence (n) : Sự tự tin
Conflict (n) : Cuộc xung đột
Conflict (v) : Xung đột, gây gổ
Confusing (adj) : Khó hiểu, gây bối rối, gây nhầm lẫn
Conscious (adj) : Có ý thức, tỉnh táo
Conservative (adj) : Bảo thủ, thận trọng
Conservative (n) : Người bảo thủ
Consideration (n) : Sự xem xét, sự cân nhắc
Consistent (adj) : Phù hợp, nhất quán
Constant (adj) : Không thay đổi
Constantly (adv) : Liên tục
Construct (v) : Xây dựng
Construction (n) : Công trình xây dựng
Contemporary (adj) : Đương thời, đương đại
Contest (n) : Cuộc thi
Contest (v) : Thi thố tranh đấu, phản đối
Contract (n) : Hợp đồng
Contract (v) : Ký hợp đồng, nhiễm bệnh
Contribute (v) : Đóng góp, xây dựng (bài)
Contribution (n) : Sự đóp góp
Convert (v) : Chuyển đổi
Convinced (adj) : Tin chắc
Core (adj) : Cốt lõi, chính yếu
Core (n) : Trung tâm, lõi
Coporate (adj) : Thuộc doạn nghiệp, thuộc công ty
Council (n) : Hội đồng
County (n) : Quận hạt, khu hành chính
Courage (n) : Lòng can đảm
Crash (n) : Sự sụp đổ, tai nạn
Crash (v) : Sụp đổ, đâm sầm vào
Creation (n) : Tác phẩm tạo ra
Creature (n) : Sinh vật, loài vật
Credit (v) : Ghi công, ghi nhận đóng góp
Crew (n) : Phi hành đoàn
Crisis (n) : Cuộc khủng hoảng
Criterion (n) : Tiêu chuẩn
Critic (n) : Nhà phê bình
Critical (adj) : Nghiêm trọng, ccos hành động chỉ trích
Criticism (n) : Sự chỉ trích, lời phê bình
Criticize (v) : Chỉ trích, lên án
Crop (n) : Vụ mùa
Crucial (adj) : Quan trọng, cốt yếu
Cry (n) : Tiếng kêu la
Cure (v) : Chữa trị, chữa khỏi
Cure (n) : Cách chữa trị
Current (n) : Dòng, luồn điện
Curve (n) : Đường cong
Curve (v) : Uốn cong
Curved (adj) : Cong
Date (v) : Để ngày tháng
Debate (n) : Cuộc tranh luận
Debate (v) : Tranh luận
Decline (n) : Sự suy giảm
Decline (v) : Từ chối
Debt (n) : Món nộ
Declare (v) : Khai báo
Decent (adj) : Đàng hoàng, lịch sự
Decorate (v) : Trang hoàng, trang trí
Decoration (n) : Sự trang hoàng, đồ trang hoàng, trang trí
Decorative (adj) : Để trang hoàng, để trang trí, để làm cảnh
Decrease (v), (n) : Giảm bớt, làm suy giảm, sự giảm đi, sự giảm sút
Deep (adj): Sâu, khó lường, bí ẩn
Deeply (adv) : Sâu, sâu xa, sâu sắc
Defeat (v): Đánh bại; sự thất bại (kế hoạch), sự tiêu tan (hy vọng)
Defence (n) : Vật để chống đỡ, sự che chở
Defend (v) : Che chở, bảo vệ, bào chữa
Define (v) : Định nghĩa
Definite (adj) : Xác định, định rõ, rõ ràng
Definitely (adv) : Rạch ròi, dứt khoát
Definition (n) : Sự định nghĩa, lời định nghĩa
Degree (n) : Mức độ, trình độ; bằng cấp; độ
Delay (n), (v) : Sự chậm trễ, sự trì hoãn, sự cản trở; làm chậm trễ
Deliberate (adj) : Thận trọng, có tính toán, có suy nghĩ cân nhắc
Deliberately (adv) : Thận trọng, có suy nghĩ cân nhắc
Delicate (adj) : Thanh nhã, thanh tú, tế nhị, khó xử
Delight (n), (v) : Sự vui sướng, điều thích thú, làm say mê
Delighted (adj) : Vui mừng, hài lòng
Deliver (v) : Cứu khỏi, thoát khỏi, bày tỏ, giãi bày
Delivery (n) : Sự phân phát, sự giao hàng, sự bày tỏ, phát biểu
Demand (n) : Sự đòi hỏi, sự yêu cầu
Demand (v) : Đòi hỏi, yêu cầu
Demonstrate (v) : Chứng minh, giải thích; bày tỏ, biểu lộ
Dentist (n) : Nha sĩ
Deny (v) : Từ chối, phản đối, phủ nhận
Department (n) : Cục, sở, ty, ban, khoa; gian hàng, khu bày hàng
Departure (n) : Sự rời khỏi, sự đi, sự khởi hành
Depend on (v) : Phụ thuộc, tùy thuộc; dựa vào, ỷ vào, trông mong vào
Deposit (n), (v) : Vật gửi, tiền gửi, tiền đặt cọc; gửi, đặt cọc
Depress (v) : Làm chán nản, làm phiền muộn; làm suy giảm
Depressing (adj) : Làm chán nản làm thát vọng, làm trì trệ
Dpressed (adj) : Chán nản, thất vọng, phiền muộn; suy yếu, đình trệ
Depth (n) : Chiều sâu, độ dày
Derive (v) : Nhận được từ, lấy được từ; xuất phát từ, bắt nguồn
Describe (v) : Diễn tả, miêu tả, mô tả
Description (n) : Sự mô tả, sự tả, sự miêu tả
Desert (n), (v) : Sa mạc; công lao, giá trị; rời bỏ, bỏ trốn
Deserted (adj) : Hoang vắng, không người ở
Deserve (v) : Đáng, xứng đáng
Design (n): thiết kế
Desire (n), (v) : Ước muốn; thèm muốn, ao ước
Desk (n) : Bàn (học sinh, viết, làm việc)
Desperate (adj) : Liều mạng, liều lĩnh; tuyệt vọng
Desperately (adv) : Liều lĩnh, liều mạng
Despite (prep) : Dù, mặc dù, bất chấp
Destroy (v) : Phá, phá hoại, phá huỷ, tiêu diệt, triệt phá
Destruction (n) : Sự phá hoại, sự phá hủy, sự tiêu diệt
Detail (n) (v) : Chi tiết
Detailed (adj) : Cặn kẽ, tỉ mỉ, nhiều chi tiết
Determination (n) : Sự xác định, sự định rõ; sự quyết định
Determine (v) : Xác định, định rõ; quyết định
Determined (adj) : Đã được xác định, đã được xác định rõ
Develop (v) : Phát triển, mở rộng; trình bày, bày tỏ
Development (n) : Sự phát triển, sự trình bày, sự bày tỏ
Device (n) : Kế sách; thiết bị, dụng cụ, máy móc
Devote (v) : Hiến dâng, dành hết cho
Devoted (adj) : Hiến cho, dâng cho, dành cho; hết lòng, nhiệt tình
Diagram (n) : Biểu đồ
Diamond (n) : Kim cương
Diary (n) : Sổ nhật ký; lịch ghi nhớ
Dictionary (n) : Từ điển
Dying (adj) : Sự chết
Diet (n) : Chế độ ăn uống, chế độ ăn kiêng
Dfference (n) : Sự khác nhau
Different (adj) : Khác, khác biệt, khác nhau
Differently (adv) : Khác, khác biệt, khác nhau
Difficult (adj) : Khó, khó khăn, gay go
Difficulty (n) : Sự khó khăn, nỗi khó khăn, điều cản trở
Discount (n) : Sự bớt giá, sự chiết khấu, tiền bớt, chiết khấu
Discover (v) : Khám phá, phát hiện ra, nhận ra
Discovery (n) : Sự khám phá, sự tìm ra, sự phát hiện ra
Discuss (v) : Thảo luận, tranh luận
Discussion (n) : Sự thảo luận, sự tranh luận
Disease (n) : Căn bệnh, bệnh tật
Disgust (v), (n) : Làm ghê tởm, làm kinh tởm, làm phẫn nộ
Disgusting (adj) : Làm ghê tởm, kinh tởm
Disgusted (adj) : Chán ghét, phẫn nộ
Dig (v) : Đào bới, xới
Direct (adj), (v) : Trực tiếp, thẳng thắn; gửi, viết cho ai, điều khiển
Directly (adv) : Trực tiếp, thẳng
Direction (n) : Sự điều khiển, sự chỉ huy
Director (n) : Giám đốc, người điều khiển, chỉ huy
Dirt (n) : Đồ bẩn thỉu, đồ dơ bẩn, vật rác rưởi
Dirty (adj) : Bẩn thỉu, dơ bẩn
Disabled (adj) : Bất lực, không có khă năng
Disadvantage (n) : Sự bất lợi, sự thiệt hại
Disagree (v) : Bất đồng, không đồng, khác, không giống, không hợp
Disagreement (n) : Sự bất đồng, sự không đồng ý, sự khác nhau
Disappear (v) : Biến mất, biến đi
Disappoint (v) : Không làm thỏa ước nguyện, thất hứa
Disappointing (adj) : Làm chán ngán, làm thất vọng
Disappointed (adj) : Thất vọng
Disappointment (n) : Sự chán ngán, sự thất vọng
Disapproval (n) : Sự phản đổi, sự không tán thành
Disapprove of (v) : Không tán thành, phản đối, chê
Disapproving (adj) : Phản đối
Disaster (n) : Tai họa, thảm họa
Discipline (n) : Kỷ luật, khuôn phép
Edit (v) : Biên tập
Edition (n) : Phiên bản
Efficient (a) : Có hiệu quả
Elderly (a) : Trung niên, lớn tuổi, cao tuổi
Elect (v) : Trúng cử, bầu chọn
Elsewhere (adv) : Nơi khác
Emergy (v) : Xuất hiện
Emotional (a) : Dễ xúc động
Emphasis (n) : Tầm quan trọng, điểm nhấn
Emphasize (v) : Nhấn mạnh
Enable (v) : Kích hoạt, cho phép
Encounter (n) : Cuộc gặp mặt, cuộc chạm trán
Encounter (v) : Gặp phải, chạm trán
Engage (v) : Tham gia, đính hôn
Enquiry (n) : Cuộc điều tra, sự thẩm tra
Ensure (v) : Đảm bảo
Enthusiasm (n) : Sự hăng hái, sự nhiệt tình
Enthusiastic (a) : Hăng hái, nhiệt tình
Entire (a) : Toàn bộ, toàn thể
Entirely (adv) : Hoàn toàn
Equal (n) : Người cùng cấp, người đồng cấp
Establish (v) : Thành lập
Estate (n) : Tài sản
Estimate (n) : Sự ước lượng, sự ước tính
Estimate (v) : Ước tính, ước lượng
Ethical (a) : Có đạo đức
Evaluate (v) : Đánh gì
Even (a) : Đồng đều, bằng phẳng
Evil (a) : Xấu xa, hiểm độc
Evil (n) : Cái ác, sự xấu xa
Examination (n) : Bài kiểm tra
Excuse (n) : Lời biện hộ, sjw bao biện
Excuse (v) : Miễn tội, thứ lỗi
Executive (a) : Thuộc về điều hành
Executive (n) : Người điều hành
Existence (n) : Sự tồn tại
Expectation (n) : Sự kì vọng, sự mong đợi
Expense (n) : Chi phí
Exploration (n) : Cuộc thám hiểm
Expose (v) : Phơi bày, vạch trần
Extend (v) : Mở rộng
Extent (n) : Mức độ
External (a) : Bên ngoài
Extraordinary (a) : Phi thường
Extreme (n) : Thái cực
Facility (n) : Cơ sở vật chất
Failure (n) : Sự thất bại
Faith (n) : Niềm tin
Fault (n) : Lỗi lầm
Favour (v) : Ủng hộ, ưu ái
Feather (n) : Lông vũ
Fee (n) : Tiền phí
Feed (n) : Đường dẫn vật liệu, đồ ăn cho vật nuôi
Feedback (n) : Phản hồi
Feel (n) : Cảm giác mang lại
Fellow (a) : Có điểm chung
Figure (v) : Nghĩ rằng, cho rằng
File (v) : Sắp xếp hồ sơ, nộp hồ sơ
Finance (n) : Tài chính
Finance (v) : Cấp tiền
Finding (n) : Sự phát triển, sự khám phá ra
Firm (n) : Công ty
Fix (n) : Cách giải quyết
Flame (n) : Ngọn lửa
Flash (n) : Ánh sáng (lóe lên)
Flash (v) : Lóe sáng, vụt qua
Flexible (a) : Linh hoạt, mềm dẻo
Float (v) : Trôi nổi
Fold (n) : Nếp gấp
Folding (a) : Gấp lại được
Following (prep) : Tiếp theo sau
Forgive (v) : Tha thứ
Former (a) : Trước đây, cũ
Fortune (n) : Vận may, gia tài
Forward (a) : Hướng về phía trước
Free (v) : Giải phóng
Found (v) : Sáng lập
Freedom (n) : Sự tự do
Frequency (n) : Tần số
Fuel (v) : Châm ngòi
Fully (adv) : Toàn bộ
Function (v) : Hoạt động
Fund (n) : Quỹ
Fundamental (a) : Cơ bản, nền tảng
Funding (n) : Vốn, sự tài trợ
Furthermore (adv) : Hơn nữa
Gain (n) : Lợi nhuận
Gain (v) : Thu được, kiếm được
Gang (n) : Băng nhóm
Generate (v) : Tạo ra
Genre (n) : Thể loại
Govern (n) : Quản lý
Grab (v) : Túm lấy
Grade (v) : Chấm điểm, xếp cấp độ
Gradually (adv) : Dần dần
Grand (a) : To lớn, hung vĩ
Grant (n) : Khoản trợ cấp
Grant (v) : Ban cho
Guarantee (n) : Sự cam đoan
Guarantee (v) : Cam đoan, bảo đảm
Harm (n) : Sự tổn hại, sự thiệt hại
Harm (v) : Làm hại, gây hại
Harmful (adj) : Có hại
Hearing (n) : Thính giác, phiên tòa
Heaven (n) : Thiên đường
Heel (n) : Gót chân
Hell (n) : Địa ngục
Hesitate (v) : Do dự
High (n) : Cao điểm
Hire (n) : Sự thuê
Hold (n) : Sự nắm giữ
Hollow (adj) : Rỗng
Holy (adj) : Thuộc về thần thánh
Honour (n) : Danh dự
Honour (v) : Tôn kính
Host (v) : Tổ chức
House (v) : Cung câp nơi ở, chứa
Housesing (n) : Nhà ở nói chung
Humorous (adj) : Hài hước
Humor (n) : Sự hài hước
Hunt (n) : Sự tìm kiếm
Hunting (v) : Săn bắn
Hurt (n) : Sự đau khổ
Ideal (n) : Lý tưởng
Illustrate (v) : Minh họa
Illustration (n) : Hình minh họa
Imagination (n) : Trí tưởng tượng
Impatient (adj) : Thiếu kiên nhẫn
Imply (v) : Ngụ ý
Impose (v) : Sự sắp đặt
Impress (v) : Gây ấn tượng
Impressed (adj) : Cảm thấy ấn tượng
Inch (n) : Inch, một chút
Incident (n) : Biến cố
Income (n) : Thu nhập
Increasingly (adv) : Ngày càng
Industrial (adj) : Thuộc về công nghiệp
Infection (n) : Sự nhiễm trùng
inform (v) : Thông báo
Initial (adj) : Ban đầu
Initially (adv) : Lúc đầu
Initiative (n) : Sáng kiến
Inner (adj) : Bên trong
Inquiry (n) : Sự điều tra
Insight (n) : Cái nhìn sâu sắc
Insist (v) : Năn nỉ
Inspire (v) : Truyền cảm hứng
Install (v) : Cài đặt
Instance (n) : Ví dụ, trường hợp
Institute (n) : Học viện
Institution (n) : Tổ chức, cơ quan
Insurance (n) : Bảo hiểm
Intended (adj) : Có ý định
Intense (adj) : Dữ dội
Internal (adj) : Thuộc về bên trong
Interpret (v) : Giải nghĩa, phiên dịch
Interrupt (v) : Làm gián đoạn
Investigation (n) : Cuộc điều tra
Investment (v) : Đầu tư
Issue (v) : Đưa ra, cấp
Joy (n) : Niềm vui
Judgement (n) : Sự phán xét
Junior (adj) : Thuộc về cấp dưới
Justice (n) : Công lý
Justify (v) : Biện minh, chứng minh
Labour (n) : Công việc lao động, nhân công
Landscape (n) : Phong cảnh
Largely (adv) : Phần lớn
Latest (n) : Thứ mới nhất ư
Launch (n) : Sự khởi động, sự phát động, sự phóng
Leadership (n) : Khả năng lãnh đạo
League (n) : Liên đoàn
Lean (v) : Dựa vào
Leave (n) : Thời gian nghỉ phép, sự cho phép
Level (v) : Làm bằng phẳng
Licence (n) : Giấy phép
Limited (adj) : Hạn chế
Line (v) : Tạo thành hàng
Lively (adj) : Sống động
Load (n) : Tải trọng
Load (v) : Nhét vào, chất vào
Loan (n) : Khoản vay
Logical (adj) : Hợp lý
Long-term (adj) : Dài hạn
Long-term (adv) : Một cách dài hạn
Loose (adj) : Lỏng lẻo
Lord (n) : Chúa tể
Low (n) : Mức thấp
Lower (v) : Hạ thấp
Lung (n) : Phổi
Maintain (v) : Duy trì
Majority (n) : Số đông
Make (n) : Mẫu mã, đời sản phẩm
Map (v) : Bản đồ
Mass (adj) : Thuộc về lượng lớn
Massive (adj) : To lớn
Master (n) : Bậc thầy
Master (v) : Tinh thông, nắm vững
Matching (adj) : Hợp nhau, giống nhau
Material (adj) : Thuộc về vật chất
Maximum (a) : Mang tính tối đa
Maximum (n) : Tối đa
Means (n) : Cách thức
Measurement (n) : Sự đo đặc
Minor (a) : Nhỏ bé
Melt (v) : Tan chảy
Military (a) : Thuộc về quân đội
Mineral (n) : Khoáng chất
Minimum (a) : Mang tính tối thiểu
Minister (n) : Bộ trưởng, mục sư
Medium (n) : Phương tiện
Minority (a) : Thiểu số
Mission (n) : Nhiệm vụ, sứ mệnh
Mistake (v) : Nhầm lẫn
Mixed (a) : Trộn lẫn
Model (v) : Mô phỏng, làm mẫu
Modify (v) : Sửa đổi
Monitor (n) : Màn hình, giám sát viên
Moral (a) : Thuộc về đạo đức
Motor (n) : Động cơ
Motor (a) : Thuộc về động cơ
Moral (n) : Luân lý, đạo đức
Mount (v) : Tổ chức, tăng lên
Multiple (a) : Nhiều
Multiply (v) : Nhân
Mysterious (a) : Bí ẩn
Narrow (v) : Thu hẹp
National (a) : Thuộc về quốc gia
Neat (a) : Ngăn nắp
Nevertheless (adv) : Tuy nhiên
Nerve (n) : Thần kinh
Negative (n) : Sự phủ định, mặt tiêu cực
Nightmare (n) : Cơn ác mộng
Notion (n) : Ý kiến, khái niệm
Numerous (adj) : Nhiều
Obey (v) : Tuân theo
Object (v) : Phản đối
Objective (adj) : Mục tiêu
Obligation (n) : Nghĩa vụ
Observation (n) : Sự quan sát
Observe (v) : Quan sát
Obtain (v) : Đạt được
Occasionally (adv) : Thỉnh thoảng
Offence (n) : Tội, sự xúc phạm
Offensive (a) : Phản cảm
Official (n) : Công chức, viên chức
Opening (n) : Cái lỗ, sự bắt đầu, lễ khai mạc
Operate (v) : Vận hành
Opponent (n) : Đối thủ
Oppose (v) : Chống đối
Opposed (a) : Mang tính phản đối
Opposition (n) : Sự đối lập
Otherwise (adv) : Nếu không thì
Origin (n) : Nguồn gốc
organ (n) : Nội tạng
Outcome (n) : Kết quả
Outer (a) : Thuộc về bên ngoài
Outline (n) : Tóm tắt, bản phác thảo
Outline (v) : Tóm tắt
Overall (a) : Tổng thể
Owe (v) : Nợ
Pace (n) : Tốc độ
Pace (v) : Đi qua đi lại, đi tới đi lui
Package (v) : Đóng gói
Panel (n) : Bảng điều khiến
Parliament (n) : Nghị viện
Participant (n) : Người tam gia
Partly (adv) : Một phần
Passage (n) : Lối đi, đoạn văn
Patient (a) : Kiên nhẫn
Pension (n) : Lương hưu
Permit (n) : Giấy phép
Permanent (adj) : Dài hạn, vĩnh viễn
Permit (v) : Cho phép
Perspective (n) : Góc nhìn, quan điểm
Phase (n) : Giai đoạn
Phenomenom (n) : Hiện tượng
Philosophy (n) : Triết học
Plain (a) : Trơn, rõ ràng
Picture (v) : Hình dung
Pitch (n) : Sân cỏ, cao độ
Pile (v) : Chất đống
Pick (n) : Sự lựa chộn
Plot (v) : Bày mưu, vẽ đồ thị
Plus (a) : Thêm vào
Plus (conj) : Ngoài ra, thêm nữa
Plus (n) : Dấu cộng, điểm cộng
Pointed (a) : Nhọn
Popularity (n) : Sự phổ biến, độ nổi tiếng
Positive (n) : Mặt tích cực
Posotion (v) : Đặt vào vị trí
Pose (v) : Tạo dáng
Possess (v) : Sở hữu
Potentional (a) : Có tiềm năng
Potentional (n) : Tiềm năng
Power (v) : Cấp năng lượng
Praise (n) : Lời khen
Pregnant (a) : Có thai
Preparation (n) : Sự chuẩn bị
Presence (n) : Sự hiện diện
